111111111111111
1P00000C0000001
111111100010C01
10C000000011111
1111000110C0001
1C00000000E0001
111111111111111