11111111
1C0C0101
10100001
1P011CE1
11111111